[console_scripts]
boxSize = galfitools.shell.commands_galin:mainGetBoxSizeDs9
checkFile = galfitools.shell.commands_galin:maincheckFile
fitlog2csv = galfitools.shell.commands_galout:mainFitlog2CSV
galSky = galfitools.shell.commands_sky:mainGalfitSky
getBT = galfitools.shell.commands_galout:maingetBT
getBarSize = galfitools.shell.commands_galout:mainGetBarSize
getBreak = galfitools.shell.commands_galout:mainGetBreak
getBreak2 = galfitools.shell.commands_galout:mainGetBreak2
getBulgeRad = galfitools.shell.commands_galout:mainGetBulgeRad
getCOW = galfitools.shell.commands_galout:maingetCOW
getFWHM = galfitools.shell.commands_galout:mainFWHM
getKappa = galfitools.shell.commands_galout:mainKappa
getKappa2 = galfitools.shell.commands_galout:mainKappa2
getMeRad = galfitools.shell.commands_galout:mainGetMeRad
getMissLight = galfitools.shell.commands_galout:mainMissingLight
getN = galfitools.shell.commands_galout:maingetN
getPeak = galfitools.shell.commands_galout:maingetPeak
getReComp = galfitools.shell.commands_galout:mainGetReComp
getSersic = galfitools.shell.commands_galin:maingetSersic
getSlope = galfitools.shell.commands_galout:maingetSlope
getStar = galfitools.shell.commands_galin:mainGetStar
gtmakeMask = galfitools.shell.commands_galin:mainMakeMask
imarith = galfitools.shell.commands_galin:main_imarith
initGal = galfitools.shell.commands_galin:mainInitGal
makePSF = galfitools.shell.commands_galin:mainMakePSF
makeSim = galfitools.shell.commands_sim:mainMakeSim
maskDs9 = galfitools.shell.commands_galin:mainMaskDs9
maskSky = galfitools.shell.commands_galin:mainMaskSky
mge2galfit = galfitools.shell.commands_mge:mainMGE
photDs9 = galfitools.shell.commands_galout:mainPhotDs9
sbProf = galfitools.shell.commands_mge:mainSbProf
showCube = galfitools.shell.commands_galout:mainShowCube
skyDs9 = galfitools.shell.commands_sky:mainSkyDs9
skyRing = galfitools.shell.commands_sky:mainSkyRing
xy2fits = galfitools.shell.commands_galin:mainxy2fits
